蒙晨皓	黄柳媛
阮奕菲	肖文宇
李思吾	莫婷婷
李享	廖嘉家
黄道锋	刘柳思
唐嘉琪	覃杨炀
蔡耀德	兰倩云
梁雨琴	张聿怀
蓝彧文	林丽雯
丁文君	罗润宇
刘子铭	黄裕涛
韦芷娴	谭淮文
杨聪颖	沈钟立
陈百灵	曾尚泓
朱晓琳	覃柳叶
韦国阳	邓欣
李晚绿	王艳
朱泰荣	甘昕玥
高晨璐	农真健
顾锦菲	陈治州
林昕	彭千航
黄雪云	侯宇萍
蔡雪玉	张哲睿
慕浩宸	唐思
徐瑱璐	杨陆凯
闭水劲	潘欣如
陈伟奎	谢俊琨
赵鸿渝	陶近月
韦秋婷	时文豪
张航	杨昕昀
周君兰	戚椿林
